111111111111111111111111111111
101000000000000000000000010001
101000000000000000000000010001
1010000000000S0000000000010001
101000000000000000000000010001
101000000000000000000000010001
10100000000001P1100000S0010001
101000S00000001000000000010001
10ES0000000S000000000000010001
101000000000000000000000010001
101000S000000000SCS00000010001
10100000000000000S000000000001
101000000000000000000000010001
111111111111111111111111111111