111111111111111111111111111111
101RRRRRRRRRRRRRRRRRR000010001
101RRRRRRRRRRRRRRRRRR000010001
101RRRRRR000RSRRRRRR0000010001
101RRRRRRRRRRRRRRRRRR000010001
101RRRRRRRRRR00RRRRRR000010001
101RRRRRR00001P1100000S0010001
101000SRRRRRR01RRRRRR000010001
10ECRRRRRR0SRRRRRRRRRRRR010001
101RRRRRRRRRRRRRRRRRR000010001
101000SRRRRRR000SCSRRRRRR10001
101RRRRRRRRRRRR00SRRRRRR000001
101RRRRRRRRRRRRRRRRRR000010001
111111111111111111111111111111