11111111111111
10000000000001
10000000000001
10000000S00001
10000000000001
10000000000001
10000001P11001
1S000000100001
1E000S00000001
10000000000001
1S00000000SCS1
10000000000S01
10000000000001
11111111111111